5-3
00000000000
01111111110
01111111110
01111111110
01111111110
01111111110
01100000000
01100000000
01100000000
01100000000
01100000000
01111111110
01111111110
01111111110
01111111110
01111111110
00000000000