5-3
00000000000
06222222270
03111111140
03111111140
03111111140
03a55555580
03400000000
03400000000
03400000000
03400000000
03400000000
03d22222270
03111111140
03111111140
03111111140
09555555580
00000000000